1
0 4 12 20 24

2
6 8 11 13 16 18

3
6 8 10 12 14 16 18

4
15 1 9 23 7 11 13 17

5
2 5 9 11 12 13 15 19 22

6
0 2 4 8 16 27 19

7
1 6 7 13 27 28 34 35

8
30 20 10 0 14 28 12 19 20

9
1 6 7 13 27 28 34 35

10
25 26 27 20 21 22 15 16 17 10 11

11
0 5 13 14 22 27 30 33 38 39 47

12
15 9 17 18 19 33 39 31 30 29

13
0 6 8 12 24 30 32 36 40 42 48

14
2 20 46 28 8 9 11 12 29 36 33 34

15
1 5 6 7 13 15 16 18 19 23 25 26 30

16
18 14 45 49 1 23 60 24 33 27 21

17
3 4 10 13 16 17 21 22 31 36 43 50

18
9 19 26 41 34 36 51 53 53 28 12 14 23 38

19
1 2 5 6 10 13 19 20 26 29

20
2 3 46 35 26 11 17 37 49 33 51 44 45 22 13

